# Simple Farming World Map - 25x20 tiles for better visibility
# Key: 0=grass, 1=farmland, 2=water, 3=stone, 4=trees, 5=building
0 0 0 0 0 0 0 0 0 0 0 0 0 0 0 0 0 0 0 0 0 0 0 0 0
0 4 4 4 4 4 4 4 4 0 0 0 0 0 0 0 4 4 4 4 4 4 4 4 0
0 4 0 0 0 0 0 0 4 0 0 0 0 0 0 0 4 0 0 0 0 0 0 4 0
0 4 0 1 1 1 1 0 4 0 0 0 0 0 0 0 4 0 1 1 1 1 0 4 0
0 4 0 1 1 1 1 0 4 0 0 0 0 0 0 0 4 0 1 1 1 1 0 4 0
0 4 0 1 1 1 1 0 4 0 0 0 0 0 0 0 4 0 1 1 1 1 0 4 0
0 4 0 0 0 0 0 0 4 0 0 0 0 0 0 0 4 0 0 0 0 0 0 4 0
0 4 4 4 4 4 4 4 4 0 0 0 0 0 0 0 4 4 4 4 4 4 4 4 0
0 0 0 0 0 0 0 0 0 0 0 0 0 0 0 0 0 0 0 0 0 0 0 0 0
0 0 0 0 0 0 0 0 0 0 2 2 2 2 2 0 0 0 0 0 0 0 0 0 0
0 0 0 0 0 0 0 0 0 0 2 2 2 2 2 0 0 0 0 0 0 0 0 0 0
0 0 0 0 0 0 0 0 0 0 2 2 2 2 2 0 0 0 0 0 0 0 0 0 0
0 0 0 0 0 0 0 0 0 0 0 0 0 0 0 0 0 0 0 0 0 0 0 0 0
0 0 0 0 0 0 0 0 0 0 0 0 0 0 0 0 0 0 0 0 0 0 0 0 0
0 0 0 0 0 0 0 0 0 0 0 0 0 0 0 0 0 0 0 0 0 0 0 0 0
0 0 0 0 0 0 0 5 5 5 5 5 5 5 5 5 0 0 0 0 0 0 0 0 0
0 0 0 0 0 0 0 5 3 3 3 3 3 3 3 5 0 0 0 0 0 0 0 0 0
0 0 0 0 0 0 0 5 3 3 3 3 3 3 3 5 0 0 0 0 0 0 0 0 0
0 0 0 0 0 0 0 5 5 5 5 5 5 5 5 5 0 0 0 0 0 0 0 0 0
0 0 0 0 0 0 0 0 0 0 0 0 0 0 0 0 0 0 0 0 0 0 0 0 0
