18 18 18 18 18 18 18 18 18 18 18 18 18 18 18 18 18 18 18 18 18 18 18 18 18 18 18 18 18 18 18 18 18 18 18 18 18 18 18 18 18 18 18 18 18 18 18 18 18 18 18 18 18 18 18 18 18 18
18 18 18 18 18 18 18 18 18 18 18 18 18 18 18 18 18 18 18 18 18 18 18 18 18 18 18 18 18 18 18 18 18 18 18 18 18 18 18 18 18 18 18 18 18 18 18 18 18 18 18 18 18 18 18 18 18 18
18 18 18 18 18 18 18 18 18 18 18 18 19 18 18 18 18 18 18 18 18 18 18 18 18 18 18 18 18 18 18 18 18 18 18 18 18 18 18 18 18 18 18 18 18 18 18 18 18 18 18 18 18 18 18 18 18 18
18 18 18 18 18 18 18 18 18 18 18 18 18 18 18 18 18 18 18 18 18 18 18 18 18 18 18 18 18 18 18 18 18 18 18 18 18 18 18 18 18 18 18 18 18 18 18 18 18 18 18 18 18 18 18 18 18 18
18 18 18 18 18 18 19 18 18 18 18 18 18 18 18 18 18 18 18 18 18 18 18 18 18 18 18 18 18 18 19 18 18 18 18 18 18 18 19 18 18 18 18 18 18 18 18 18 18 18 18 18 18 18 18 18 18 18
18 18 18 18 18 18 18 18 18 19 18 18 18 18 18 18 18 18 18 18 19 18 18 18 18 19 18 18 18 18 18 18 18 18 18 18 18 18 18 18 18 18 18 18 18 18 18 18 18 18 18 18 18 18 18 18 18 18 
18 18 18 18 18 18 18 18 18 18 18 18 18 18 18 19 18 18 18 18 18 18 18 18 18 18 18 18 18 18 18 18 19 18 19 18 18 18 18 18 18 18 18 18 18 18 18 18 18 18 18 18 18 18 18 18 18 18 
18 18 18 18 18 18 18 18 18 18 18 28 26 26 26 26 26 26 26 29 18 28 26 26 26 26 26 26 26 26 29 18 18 18 28 26 26 26 26 26 26 26 26 26 26 29 18 18 18 18 18 18 18 18 18 18 18 18 
18 18 18 18 19 18 18 18 18 18 18 24 16 34 34 34 34 34 16 25 26 27 16 1 1 1 1 1 1 1 25 26 26 26 27 16 1 12 10 10 10 10 10 10 13 23 18 18 19 18 18 18 18 18 18 18 18 18 
18 18 18 18 18 18 18 18 18 18 18 24 16 34 3 3 3 34 16 16 16 16 16 1 20 21 21 21 22 1 33 16 16 16 16 16 33 8 3 3 3 3 3 3 7 23 18 18 18 18 18 18 18 18 18 18 18 18 
18 18 18 18 18 18 18 18 18 18 18 24 16 34 3 35 3 34 16 16 16 16 16 1 23 18 18 18 24 1 33 16 16 16 16 16 33 8 3 3 3 3 3 3 7 23 18 18 18 18 19 18 18 18 18 18 18 18 
18 18 18 18 18 18 18 18 18 18 18 24 16 34 3 3 3 34 16 16 16 16 16 1 23 18 18 18 24 1 33 16 16 16 16 16 33 8 3 3 3 3 3 3 7 23 19 18 18 18 18 18 18 18 18 18 18 18 
18 18 18 18 18 19 18 18 18 18 18 24 16 34 3 3 3 34 16 16 16 16 16 1 25 26 26 26 27 1 33 16 16 16 16 16 33 8 3 3 3 3 3 3 7 23 18 18 18 18 18 18 18 18 18 18 18 18 
18 18 18 18 18 18 18 18 19 18 18 24 16 34 34 3 34 34 16 16 16 16 16 1 1 12 10 13 1 1 1 1 1 1 1 1 1 14 5 5 6 3 4 5 15 23 18 18 18 18 18 18 18 18 18 18 18 18 
18 18 18 18 18 18 18 18 18 18 18 24 16 16 16 1 16 16 16 16 16 16 16 16 16 8 3 7 17 17 17 17 17 17 17 17 17 17 17 17 8 3 7 20 21 31 18 18 18 19 18 18 18 18 18 18 18 18 
18 18 18 18 18 18 18 18 18 18 18 30 22 16 16 1 16 16 16 16 16 16 16 16 16 8 3 7 17 17 17 17 17 17 17 17 17 17 17 17 8 3 7 23 18 18 18 18 18 18 18 18 18 18 18 18 18 18 
18 18 18 18 19 18 18 18 18 18 19 18 24 16 16 1 16 16 16 16 16 16 16 16 16 8 3 7 17 17 17 17 17 17 17 17 17 17 17 17 8 3 7 23 19 18 18 18 18 18 18 18 18 18 18 18 18 18 
18 18 18 18 18 18 18 18 18 18 18 28 27 16 16 1 16 16 16 16 16 16 16 16 16 8 3 7 17 17 17 17 17 17 17 17 17 17 17 17 8 3 7 23 18 18 19 18 18 18 18 18 18 18 18 18 18 18 
18 18 18 18 18 18 18 18 18 18 28 27 16 16 16 1 16 16 16 16 16 16 16 16 16 8 3 7 17 17 17 17 17 17 17 17 17 17 12 10 11 3 7 23 18 18 18 18 18 18 18 18 18 18 18 18 18 18 
18 18 18 18 18 18 18 18 18 18 24 16 16 1 1 1 16 16 16 16 16 16 16 16 16 8 3 7 17 17 17 17 17 17 17 17 17 17 8 3 3 3 7 23 18 18 18 18 18 19 18 18 18 18 18 18 18 18 
18 18 18 18 18 18 18 18 19 18 24 16 16 1 16 16 16 16 16 16 16 16 16 16 33 8 3 7 17 17 17 17 17 17 17 17 17 17 8 3 4 5 15 23 18 18 18 18 18 18 18 18 18 18 18 18 18 18 
18 18 18 18 18 18 18 18 18 18 24 16 16 1 16 16 12 10 10 10 10 10 10 10 10 11 3 9 10 10 10 10 10 10 10 10 10 10 11 3 7 1 1 23 18 18 19 18 18 18 18 18 18 18 18 18 18 18 
18 18 18 18 18 18 19 18 18 18 24 16 16 1 16 16 8 3 3 3 3 3 3 3 3 3 3 3 3 3 3 3 3 3 3 3 3 3 3 3 7 1 20 31 18 18 18 18 18 18 18 18 18 18 18 18 18 18 
18 18 18 18 18 18 18 18 18 18 24 16 16 1 16 16 8 3 4 5 5 5 5 5 5 6 3 4 5 5 5 5 5 5 5 5 5 5 6 3 7 1 23 18 18 19 18 18 18 18 18 18 18 18 18 18 18 18 
18 18 18 18 18 18 18 18 18 18 30 22 16 1 16 16 8 3 7 16 16 16 16 16 1 8 3 7 17 17 17 17 17 17 17 17 17 17 8 3 7 1 23 18 18 18 18 18 18 18 18 18 18 18 18 18 18 18 
18 18 18 18 18 18 18 18 18 18 18 24 16 1 16 16 8 3 7 16 16 16 16 16 16 8 3 7 17 17 17 17 17 17 17 17 17 17 8 3 7 1 23 18 18 18 18 18 18 18 18 18 18 18 18 18 18 18 
18 18 18 18 18 18 18 18 18 18 18 27 16 1 16 16 8 3 7 16 16 16 16 16 16 8 3 7 17 17 17 17 17 17 17 17 17 17 8 3 7 1 23 18 18 18 18 18 18 19 18 18 18 18 18 18 18 18 
18 18 18 18 18 18 19 18 18 18 24 16 16 1 16 16 8 3 7 16 16 16 16 16 16 8 3 7 17 17 17 17 17 17 17 17 17 17 8 3 7 1 23 18 18 18 18 18 18 18 18 18 18 18 18 18 18 18 
18 18 18 18 18 18 18 18 18 18 24 16 16 1 16 16 8 3 7 16 16 16 16 16 16 8 3 7 17 17 17 17 17 17 17 17 17 17 8 3 7 1 23 18 18 18 18 18 18 18 18 18 18 18 18 18 18 18 
18 18 18 18 18 18 18 18 18 18 24 16 16 1 16 16 8 3 7 16 16 16 16 16 16 8 3 7 17 17 17 17 17 17 17 17 17 17 8 3 7 1 23 18 18 19 18 18 18 18 18 18 18 18 18 18 18 18 
18 18 18 18 18 19 18 18 18 18 24 16 16 1 12 10 11 3 7 16 16 16 16 16 16 8 3 7 17 17 17 17 17 17 17 17 17 17 14 5 15 1 23 18 18 18 18 18 18 18 18 18 18 18 18 18 18 18 
18 18 18 18 18 18 18 18 18 18 24 16 16 1 8 3 3 3 7 16 16 16 16 16 16 8 3 7 17 17 17 17 17 17 17 17 17 17 17 17 17 20 31 18 18 18 18 18 18 18 18 18 18 18 18 18 18 18 
18 18 18 18 18 18 18 18 18 19 30 22 16 1 14 5 5 5 15 16 16 16 16 16 16 8 3 7 17 17 17 17 17 17 17 17 17 17 17 17 17 23 18 19 18 18 18 18 18 18 18 18 18 18 18 18 18 18 
18 18 18 18 18 18 18 18 18 18 18 24 16 33 1 1 1 1 33 16 16 16 16 16 16 8 3 7 17 17 17 17 17 17 17 17 17 17 17 17 17 23 18 18 18 18 18 18 18 18 19 18 18 18 18 18 18 18 
18 18 18 18 18 18 18 18 18 18 18 24 16 33 1 1 2 1 33 16 16 16 16 16 16 8 3 7 17 17 17 17 17 17 17 17 17 17 17 17 17 23 18 18 18 18 18 18 18 18 18 18 18 18 18 18 18 18 
18 18 18 18 18 18 18 19 18 18 18 24 16 1 1 1 1 1 1 16 16 16 16 16 16 8 3 7 17 17 17 17 17 17 17 17 17 17 17 17 17 23 18 18 18 18 18 18 18 18 18 18 18 18 18 18 18 18 
18 18 18 18 18 18 18 18 18 18 28 27 16 16 16 16 16 16 16 16 16 16 16 16 16 8 3 7 1 17 17 17 17 17 17 17 17 17 17 17 17 23 18 18 18 18 18 18 18 18 18 18 18 18 18 18 18 18 
18 18 18 18 18 18 18 18 18 18 24 16 16 16 16 16 16 16 16 16 16 16 16 1 1 8 3 7 1 2 17 17 17 17 17 17 17 17 17 17 17 23 18 18 18 19 18 18 18 18 18 18 18 18 18 18 18 
18 18 18 18 18 18 18 18 18 18 24 16 16 16 16 16 16 16 16 16 16 16 1 1 34 34 3 34 34 1 17 17 17 17 17 17 17 17 17 17 17 23 18 18 18 18 18 18 18 18 18 18 18 18 18 18 
18 18 18 18 18 18 18 18 18 18 24 16 16 16 16 16 16 16 16 16 16 16 1 1 34 3 3 3 34 1 17 17 17 17 17 17 17 17 17 17 17 23 18 18 18 18 18 18 18 18 18 18 18 18 18 18
18 18 18 18 18 18 18 18 18 18 24 16 16 33 16 16 16 16 16 16 16 16 1 1 34 3 35 3 34 1 17 17 17 17 17 17 17 17 17 17 17 23 18 18 18 18 18 18 18 18 18 18 18 18 18 18 
18 18 18 18 18 18 18 18 19 18 24 16 16 1 16 16 1 1 1 1 1 1 1 2 34 3 3 3 34 1 17 17 17 17 17 17 17 17 17 17 17 23 18 18 18 18 18 18 18 18 18 18 18 18 18 18 
18 18 18 18 18 18 18 18 18 18 24 16 16 1 1 1 1 16 20 21 21 22 1 1 34 3 3 3 34 1 20 21 21 22 17 17 17 17 17 17 17 23 18 18 18 18 18 18 18 18 18 18 18 18 18 18 
18 18 18 18 19 18 18 18 18 18 24 16 16 16 16 16 16 20 31 18 18 30 22 1 34 34 34 34 34 20 31 18 18 24 17 17 17 17 17 17 17 23 18 18 18 18 18 19 18 18 18 18 18 18 18 18 
18 18 18 18 18 18 18 18 18 18 30 21 21 21 21 21 21 31 18 18 18 18 30 21 21 21 21 21 21 31 18 18 18 30 22 17 17 17 17 17 17 23 18 18 18 19 18 18 18 18 18 18 18 18 18 18 18 18 
18 18 18 18 18 18 18 18 18 18 18 18 18 18 18 18 18 19 18 18 18 18 18 18 18 18 18 18 18 18 18 19 18 18 30 21 21 21 21 21 21 31 18 18 18 18 18 18 18 18 18 18 18 18 18 18 18 18 
18 18 18 18 18 18 18 19 18 18 18 18 18 18 18 18 18 18 18 18 18 18 18 18 18 18 18 18 18 18 18 18 18 18 18 19 18 18 18 18 18 18 19 18 18 18 18 18 18 18 18 18 18 18 18 18 18 18 
18 18 18 18 18 18 18 18 18 18 18 18 19 18 18 18 18 18 18 18 18 18 18 18 18 18 19 18 18 18 18 18 18 18 18 18 18 18 18 18 18 18 18 18 18 18 18 18 19 18 18 18 18 18 18 18 18 18 
18 18 18 18 18 18 18 18 18 18 18 18 18 18 18 18 18 18 18 18 18 18 18 18 18 18 18 18 18 18 18 18 18 18 18 18 18 18 18 18 18 18 18 18 18 18 18 18 18 18 18 18 18 18 18 18 18 18 
18 18 18 18 18 18 18 18 18 18 18 18 18 18 18 18 18 18 18 18 18 18 18 18 18 18 18 18 18 18 18 18 18 18 18 18 18 18 18 18 18 18 18 18 18 18 18 18 18 18 18 18 18 18 18 18 18 18 
18 18 18 18 18 18 18 18 18 18 18 18 18 18 18 18 18 18 18 18 18 18 18 18 18 18 18 18 18 18 18 18 18 18 18 18 18 18 18 18 18 18 18 18 18 18 18 18 18 18 18 18 18 18 18 18 18 18 
18 18 18 18 18 18 18 18 18 18 18 18 18 18 18 18 18 18 18 18 18 18 18 18 18 18 18 18 18 18 18 18 18 18 18 18 18 18 18 18 18 18 18 18 18 18 18 18 18 18 18 18 18 18 18 18 18 18